; NON-PLATED HOLES START AT T1
; THROUGH (PLATED) HOLES START AT T100
M48
INCH
T100C0.038445
T101C0.038417
T102C0.030000
T103C0.035000
T104C0.038000
%
T100
X004100Y019923
X012700Y019923
X013700Y019923
X005100Y019923
X006100Y019923
X014700Y019923
X015700Y019923
X007100Y019923
X016700Y019923
X008100Y019923
X001100Y019923
X009100Y019923
X010100Y019923
X017700Y019923
X018700Y019923
X002100Y019923
X011700Y019923
X003100Y019923
T101
X015700Y000923
X016700Y000923
X007700Y000923
X008700Y000923
X017700Y000923
X010700Y000923
X018700Y000923
X011700Y000923
X009700Y000923
X013700Y000923
X004700Y000923
X005700Y000923
X006700Y000923
X014700Y000923
T102
X004700Y012923
X005700Y012923
X006700Y012923
X007700Y012923
X008700Y012923
X010700Y012923
X011700Y012923
X009700Y012923
X002700Y012923
X003700Y012923
T103
X011700Y003923
X008700Y005923
X004700Y010923
X007700Y003923
X013700Y010923
X004700Y005923
X009700Y010923
X008700Y010923
T104
X016700Y009923
X016700Y010923
X002700Y004923
X002700Y009923
X002700Y010923
X016700Y005923
X002700Y005923
X016700Y004923
T00
M30
